1111111111111
10010100000C1
1000000011001
1P0011E000001
10010100000E1
1111111111111
