111111111111111111111111111111111111111111111111111111111111111111111111111111111111111111111111111111111111111111111111
10P000000000000000000000000000000000000000000000000000C000000000000000000000E0000000000000000000000000000000000000011111
111111111111111111111111111111111111111111111111111111111111111111111111111111111111111111111111111111111111111111111111
